"filename", "language", "Java", "Markdown", "comment", "blank", "total"
"c:\Users\azhu6\Documents\GitHub\FBLA\FBLA-WordGame\FBLA-Project\README.md", "Markdown", 0, 1, 0, 0, 1
"c:\Users\azhu6\Documents\GitHub\FBLA\FBLA-WordGame\FBLA-Project\src\entity\Entity.java", "Java", 13, 0, 0, 5, 18
"c:\Users\azhu6\Documents\GitHub\FBLA\FBLA-WordGame\FBLA-Project\src\entity\Player.java", "Java", 122, 0, 10, 25, 157
"c:\Users\azhu6\Documents\GitHub\FBLA\FBLA-WordGame\FBLA-Project\src\main\Collision.java", "Java", 0, 0, 35, 9, 44
"c:\Users\azhu6\Documents\GitHub\FBLA\FBLA-WordGame\FBLA-Project\src\main\GamePanel.java", "Java", 64, 0, 1, 28, 93
"c:\Users\azhu6\Documents\GitHub\FBLA\FBLA-WordGame\FBLA-Project\src\main\KeyHandler.java", "Java", 41, 0, 0, 5, 46
"c:\Users\azhu6\Documents\GitHub\FBLA\FBLA-WordGame\FBLA-Project\src\main\Main.java", "Java", 17, 0, 0, 5, 22
"c:\Users\azhu6\Documents\GitHub\FBLA\FBLA-WordGame\FBLA-Project\src\tile\Tile.java", "Java", 6, 0, 0, 1, 7
"c:\Users\azhu6\Documents\GitHub\FBLA\FBLA-WordGame\FBLA-Project\src\tile\TileManager.java", "Java", 80, 0, 1, 26, 107
"Total", "-", 343, 1, 47, 104, 495